1 8
-2300 0 2000
200 200
3 0 10

50 14
6
73 150
4 0 0

0 0
0 300
0 600
0 900
0 1200
0 1500

8
-600 50 4250 50 100 6 0 0
-200 80 4200 80 160 6 0 0
200  75 4250 73 150 4 0 0
600  50 4300 50 100 6 0 0
-600 85 4750 140 170 6 0 0
-200 75 4700 73 150 4 0 0
200  75 4750 73 150 4 0 0
600  75 4800 100 150 6 0 0

8
-600 0 4250 200 200 3 0 8
-200 0 4200 200 160 3 0 9
200  0 4250 160 200 3 0 10
600  0 4300 300 300 3 0 11
-600 0 4750 300 200 3 0 32
-200 0 4700 200 200 3 0 42
200  0 4750 100 100 3 0 13
600  0 4800 160 160 3 0 19

55
